{
  "map": [
    [ 0, 0, 0, 0, 0, 0, 0, 0, 0, 0, 0, 0, 0, 0, 0, 0, 0, 0, 0, 0, 0, 0, 0, 0, 0 ],
    [ 0, 1, 1, 1, 1, 1, 1, 1, 1, 1, 0, 1, 1, 1, 1, 1, 1, 1, 0, 1, 1, 1, 1, 1, 0 ],
    [ 0, 1, 1, 1, 1, 1, 1, 1, 1, 1, 1, 1, 1, 4, 4, 1, 1, 1, 1, 1, 1, 1, 1, 1, 0 ],
    [ 0, 1, 1, 1, 1, 1, 1, 1, 1, 1, 1, 1, 1, 4, 4, 1, 1, 1, 0, 1, 1, 1, 1, 1, 0 ],
    [ 0, 1, 1, 1, 1, 1, 1, 1, 1, 1, 0, 1, 1, 1, 1, 1, 1, 1, 0, 1, 1, 0, 1, 1, 0 ],
    [ 0, 1, 0, 0, 1, 0, 0, 1, 1, 1, 0, 0, 0, 0, 0, 1, 1, 0, 0, 1, 1, 0, 1, 1, 0 ],
    [ 0, 1, 1, 1, 1, 1, 1, 1, 1, 1, 4, 1, 1, 1, 1, 1, 1, 1, 1, 1, 1, 0, 4, 1, 0 ],
    [ 0, 1, 1, 1, 1, 1, 1, 1, 1, 4, 1, 1, 1, 1, 1, 1, 1, 1, 1, 1, 1, 0, 1, 1, 0 ],
    [ 0, 1, 0, 0, 1, 0, 0, 1, 1, 1, 1, 1, 1, 1, 4, 4, 1, 1, 1, 1, 1, 0, 1, 1, 0 ],
    [ 0, 1, 0, 1, 1, 1, 0, 1, 1, 1, 0, 0, 1, 1, 1, 1, 0, 1, 1, 0, 0, 0, 1, 4, 0 ],
    [ 0, 1, 0, 1, 1, 1, 0, 4, 4, 1, 1, 0, 0, 1, 4, 4, 1, 1, 1, 1, 1, 0, 1, 1, 0 ],
    [ 0, 1, 0, 1, 1, 1, 0, 1, 1, 1, 1, 1, 0, 1, 1, 1, 1, 1, 1, 1, 1, 0, 1, 1, 0 ],
    [ 0, 1, 0, 1, 1, 1, 0, 1, 1, 1, 1, 1, 1, 1, 1, 1, 1, 1, 1, 1, 1, 1, 1, 1, 0 ],
    [ 0, 1, 0, 1, 1, 1, 0, 1, 1, 1, 1, 1, 1, 1, 1, 1, 1, 1, 1, 1, 1, 1, 1, 1, 0 ],
    [ 0, 1, 0, 0, 1, 0, 0, 1, 1, 1, 0, 0, 0, 0, 1, 1, 0, 0, 1, 0, 1, 4, 4, 1, 0 ],
    [ 0, 1, 1, 1, 1, 1, 1, 1, 1, 1, 0, 1, 1, 4, 1, 1, 1, 0, 4, 0, 1, 1, 1, 1, 0 ],
    [ 0, 1, 1, 1, 1, 1, 1, 1, 1, 1, 0, 1, 1, 4, 1, 1, 1, 0, 1, 0, 0, 1, 1, 1, 0 ],
    [ 0, 1, 1, 1, 1, 1, 1, 1, 1, 1, 1, 1, 1, 1, 1, 1, 1, 1, 1, 1, 1, 1, 1, 1, 0 ],
    [ 0, 1, 1, 1, 1, 1, 1, 1, 1, 1, 0, 1, 1, 1, 1, 1, 1, 0, 1, 1, 1, 1, 1, 1, 0 ],
    [ 0, 0, 0, 0, 0, 0, 0, 0, 0, 0, 0, 0, 0, 0, 0, 0, 0, 0, 0, 0, 0, 0, 0, 0, 0 ]
  ],

  "decorationMap": [
    [ 1, 3, 3, 3, 3, 3, 3, 3, 3, 3, 4, 3, 3, 3, 3, 3, 3, 3, 4, 3, 3, 3, 3, 3, 2 ],
    [ 12, 0, 0, 0, 0, 0, 0, 0, 0, 0, 7, 0, 0, 0, 0, 0, 0, 0, 7, 0, 0, 0, 0, 0, 12 ],
    [ 12, 0, 0, 0, 0, 0, 0, 0, 0, 0, 0, 0, 0, 0, 0, 0, 0, 0, 0, 0, 0, 0, 0, 0, 12 ],
    [ 12, 0, 0, 0, 0, 0, 0, 0, 0, 0, 0, 0, 0, 0, 0, 0, 0, 0, 15, 0, 0, 0, 0, 0, 12 ],
    [ 12, 0, 0, 0, 0, 0, 0, 0, 0, 0, 15, 0, 0, 0, 0, 0, 0, 0, 12, 0, 0, 15, 0, 0, 12 ],
    [ 12, 0, 16, 6, 0, 16, 6, 0, 0, 0, 10, 3, 3, 3, 6, 0, 0, 16, 11, 0, 0, 12, 0, 0, 12 ],
    [ 12, 0, 0, 0, 0, 0, 0, 0, 0, 0, 0, 0, 0, 0, 0, 0, 0, 0, 0, 0, 0, 12, 0, 0, 12 ],
    [ 12, 0, 0, 0, 0, 0, 0, 0, 0, 0, 0, 0, 0, 0, 0, 0, 0, 0, 0, 0, 0, 12, 0, 0, 12 ],
    [ 12, 0, 1, 6, 0, 16, 2, 0, 0, 0, 0, 0, 0, 0, 0, 0, 0, 0, 0, 0, 0, 12, 0, 0, 12 ],
    [ 12, 0, 12, 0, 0, 0, 12, 0, 0, 0, 16, 2, 0, 0, 0, 0, 34, 0, 0, 16, 3, 14, 0, 0, 12 ],
    [ 12, 0, 12, 0, 0, 0, 12, 0, 0, 0, 0, 10, 2, 0, 0, 0, 0, 0, 0, 0, 0, 12, 0, 0, 12 ],
    [ 12, 0, 12, 0, 0, 0, 12, 0, 0, 0, 0, 0, 7, 0, 0, 0, 0, 0, 0, 0, 0, 7, 0, 0, 12 ],
    [ 12, 0, 12, 0, 0, 0, 12, 0, 0, 0, 0, 0, 0, 0, 0, 0, 0, 0, 0, 0, 0, 0, 0, 0, 12 ],
    [ 12, 0, 12, 0, 0, 0, 12, 0, 0, 0, 0, 0, 0, 0, 0, 0, 0, 0, 0, 0, 0, 0, 0, 0, 12 ],
    [ 12, 0, 10, 6, 0, 16, 11, 0, 0, 0, 1, 3, 3, 6, 0, 0, 16, 2, 0, 15, 0, 0, 0, 0, 12 ],
    [ 12, 0, 0, 0, 0, 0, 0, 0, 0, 0, 12, 0, 0, 0, 0, 0, 0, 12, 0, 12, 0, 0, 0, 0, 12 ],
    [ 12, 0, 0, 0, 0, 0, 0, 0, 0, 0, 7, 0, 0, 0, 0, 0, 0, 7, 0, 10, 6, 0, 0, 0, 12 ],
    [ 12, 0, 0, 0, 0, 0, 0, 0, 0, 0, 0, 0, 0, 0, 0, 0, 0, 0, 0, 0, 0, 0, 0, 0, 12 ],
    [ 12, 0, 0, 0, 0, 0, 0, 0, 0, 0, 15, 0, 0, 0, 0, 0, 0, 15, 0, 0, 0, 0, 0, 0, 12 ],
    [ 10, 3, 3, 3, 3, 3, 3, 3, 3, 3, 5, 3, 3, 3, 3, 3, 3, 5, 3, 3, 3, 3, 3, 3, 11 ]
  ]
}